###############
#_____________#
#_____________#
#_____________#
#______0______#
#_____###_____#
#_____________#
#_____________#
#_____________#
###############