______________#
______________#
______________#
______________#
______________#
______________#
______________#
______________#
#__r______b___#
###############